2 2 2 2 2 2 2 2 2 2 111 113 268 268 268 268 268 268 268 268 268 268 268 268 282 288 287 287 287 287 286 268 268 268 268 268 268 268 268 268 268 268 268 268 268 198 176 2 2 2 2 2 2 2 2 2 2 2 2 2 
2 2 2 2 2 2 0 0 0 0 110 114 267 267 267 267 267 267 267 267 267 267 267 267 281 283 284 284 284 284 285 269 284 284 284 284 284 267 267 267 267 267 267 267 267 197 176 0 0 0 0 0 0 0 2 2 2 2 2 2 
2 2 2 2 2 0 0 0 0 0 110 115 158 158 158 158 158 158 158 158 158 158 158 158 280 249 246 240 241 233 235 271 158 158 158 158 158 158 158 158 158 158 158 158 158 196 176 0 0 0 0 0 0 0 0 2 2 2 2 2 
2 2 2 2 0 0 0 4 5 0 110 115 158 158 158 158 158 158 158 158 158 158 158 158 279 278 277 276 275 274 273 272 158 158 158 158 158 158 158 158 158 158 158 158 158 196 176 0 0 0 4 5 0 0 0 2 2 2 2 2 
2 2 2 0 0 0 0 6 7 0 110 115 158 158 158 158 158 158 158 158 158 158 158 158 158 158 158 265 264 158 158 158 158 158 158 158 158 158 158 158 158 158 158 158 158 196 176 0 0 0 6 7 0 0 0 2 2 2 2 2 
2 2 2 2 0 0 0 0 0 0 110 115 158 158 158 116 117 296 296 224 296 296 199 254 158 259 290 260 261 290 262 158 289 199 199 199 199 224 199 199 199 200 158 158 158 196 176 0 0 0 0 0 0 0 0 2 2 2 2 2 
2 2 2 2 0 0 0 0 0 0 110 115 158 158 158 120 118 225 225 225 225 225 253 256 232 258 266 266 266 266 263 232 231 226 225 225 225 225 225 225 225 201 158 158 158 196 176 0 0 0 0 0 0 0 0 2 2 2 2 2 
2 2 2 2 0 0 0 0 0 0 110 115 158 158 158 120 128 0 0 0 0 0 251 249 246 245 242 240 241 233 235 233 230 228 0 0 0 0 0 0 203 201 158 158 158 196 176 0 0 302 304 0 0 0 0 2 2 2 2 2 
2 2 2 2 0 0 0 0 0 0 110 115 158 158 158 120 128 0 0 0 0 0 250 248 247 244 243 239 238 237 236 234 229 227 0 0 0 0 0 0 203 201 158 158 158 196 176 0 0 301 300 0 0 0 0 2 2 2 2 2 
0 0 0 0 0 0 0 0 0 0 108 109 158 158 158 120 128 0 0 0 0 0 0 0 0 0 291 292 293 294 0 0 0 0 0 0 0 0 0 0 203 201 158 158 158 193 195 0 0 0 297 0 0 0 0 2 2 2 2 2 
0 0 0 0 0 0 0 0 0 0 107 106 158 158 158 120 128 0 0 0 0 0 0 0 0 0 217 216 215 218 0 0 0 0 0 0 0 0 0 0 203 201 158 158 158 192 194 0 0 0 297 0 0 0 0 2 2 2 2 2 
0 0 0 0 0 0 0 0 0 0 0 105 158 158 158 120 128 0 0 0 0 0 0 0 0 0 217 216 215 218 0 0 0 0 0 0 0 0 0 0 203 201 158 158 158 191 0 0 0 0 297 0 0 0 0 2 2 2 2 2 
0 0 0 0 0 0 0 0 0 0 0 105 158 158 158 120 119 0 0 0 4 5 0 0 0 0 217 216 215 218 0 0 0 0 0 4 5 0 0 0 203 201 158 158 158 191 0 0 0 0 297 0 0 0 0 2 2 2 2 2 
0 0 0 0 0 0 0 0 0 0 0 105 158 158 158 120 119 0 0 0 6 7 0 0 0 0 217 216 215 218 0 0 0 0 0 6 7 0 0 0 203 201 158 158 158 191 0 0 0 0 297 0 0 0 0 2 2 2 2 2 
2 2 2 0 0 0 0 0 0 0 0 105 158 158 158 120 119 0 0 0 0 0 0 0 0 0 217 216 215 218 0 0 0 0 0 0 0 0 0 0 203 201 158 158 158 191 0 0 0 0 297 0 0 0 0 2 2 2 2 2 
2 2 2 2 0 0 0 0 0 0 0 105 158 158 158 120 119 0 0 0 0 0 0 0 0 0 217 216 215 218 0 0 0 0 0 0 0 0 0 0 203 201 158 158 158 191 0 0 0 0 297 0 0 0 2 2 2 2 2 2 
2 2 2 2 0 0 0 0 0 0 103 104 158 158 158 122 121 0 0 0 0 0 0 0 0 0 217 216 215 218 0 0 0 0 0 0 0 0 0 0 204 205 158 158 158 190 189 0 0 0 297 0 0 2 2 2 2 2 2 2 
2 2 2 2 0 0 0 0 0 0 101 115 158 158 158 158 123 0 0 0 0 0 0 0 0 0 217 216 215 218 0 0 0 0 0 0 0 0 0 0 206 158 158 158 158 188 185 0 0 0 297 0 0 2 2 2 2 2 2 2 
2 2 2 2 0 0 0 0 0 0 101 115 158 158 158 158 123 0 0 0 0 0 0 0 0 0 217 216 215 218 0 0 0 0 0 0 0 0 0 0 206 158 158 158 158 188 185 0 0 0 297 0 0 2 2 2 2 2 2 2 
2 2 2 2 0 0 0 0 0 0 101 115 158 158 158 158 123 0 0 0 0 0 0 0 0 0 217 216 215 218 0 0 0 0 0 0 0 0 0 0 206 158 158 158 158 188 185 0 0 0 297 0 0 2 2 2 2 2 2 2 
2 2 2 2 0 0 0 0 0 0 101 102 158 158 158 125 124 0 0 0 0 0 0 0 0 0 217 216 215 218 0 0 0 0 0 0 0 0 0 0 206 208 158 158 158 187 185 0 0 0 297 0 0 2 2 2 2 2 2 2 
2 2 2 2 0 0 0 0 0 0 100 99 158 158 158 137 126 0 0 0 0 0 0 0 0 0 217 216 215 218 0 0 0 0 0 0 0 0 0 0 207 171 158 158 158 186 184 0 0 0 297 0 0 2 2 2 2 2 2 2 
2 2 2 2 0 0 0 0 0 0 0 98 158 158 158 137 127 0 0 0 0 0 0 0 0 0 217 216 215 218 0 0 0 0 0 0 0 0 0 0 209 171 158 158 158 182 183 0 0 0 297 0 0 2 2 2 2 2 2 2 
2 2 2 2 0 0 0 0 0 0 0 97 158 158 158 137 128 0 0 0 0 0 0 0 0 0 217 216 215 218 0 0 0 0 0 0 0 0 0 0 210 171 158 158 158 181 0 0 0 0 297 0 0 2 2 2 2 2 2 2 
2 2 2 2 0 0 0 0 0 0 0 97 158 158 158 137 128 0 0 0 0 0 0 0 0 0 217 216 215 218 0 0 0 0 0 0 0 0 0 0 210 171 158 158 158 181 0 0 0 0 297 0 0 2 2 2 2 2 2 2 
2 2 2 2 0 0 0 0 0 0 0 97 158 158 158 137 128 0 0 0 0 0 0 0 0 0 217 216 215 218 0 0 0 0 0 0 0 0 0 0 210 171 158 158 158 181 0 0 0 0 297 0 0 2 2 2 2 2 2 2 
2 2 2 2 0 0 0 0 0 0 0 97 158 158 158 137 128 0 0 0 0 0 0 0 0 0 217 216 215 218 0 0 0 0 0 0 0 0 0 0 210 171 158 158 158 181 0 0 0 0 297 0 0 2 2 2 2 2 2 2 
2 2 2 2 0 0 0 0 0 0 0 97 158 158 158 137 129 132 132 132 132 132 132 132 132 132 161 216 215 169 214 170 170 170 170 170 170 214 214 214 211 171 158 158 158 181 0 0 0 0 297 0 0 2 2 2 2 2 2 2 
2 2 2 2 0 0 0 0 0 0 0 97 158 158 158 130 131 131 131 131 131 131 131 131 131 133 220 216 215 165 172 173 173 173 173 173 173 213 213 213 213 212 158 158 158 181 0 0 0 0 297 0 0 2 2 2 2 2 2 2 
2 2 2 2 0 0 0 0 0 0 94 96 158 158 158 158 158 158 158 158 158 158 158 158 158 137 135 154 155 156 171 158 158 158 158 158 158 158 158 158 158 158 158 158 158 180 179 0 0 0 297 0 0 2 2 2 2 2 2 2 
2 2 2 2 0 0 0 0 0 0 93 95 158 158 158 158 158 158 158 158 158 158 158 158 158 137 136 153 153 157 171 158 158 158 158 158 158 158 158 158 158 158 158 158 158 178 176 0 0 0 297 0 0 2 2 2 2 2 2 2 
2 2 2 2 0 0 0 0 0 0 93 171 158 158 158 158 158 158 158 158 158 158 158 158 158 137 138 152 160 159 171 158 158 158 158 158 158 158 158 158 158 158 158 158 158 221 176 0 0 0 297 0 0 2 2 2 2 2 2 2 
2 2 2 2 0 0 0 0 0 0 93 171 158 158 158 158 158 158 158 158 158 158 158 158 158 137 220 216 215 165 171 158 158 158 158 158 158 158 158 158 158 158 158 158 158 221 176 0 0 0 297 0 0 2 2 2 2 2 2 2 
2 2 2 2 0 0 0 0 0 0 92 222 149 149 149 149 149 149 148 158 158 158 158 158 158 137 220 216 215 165 171 158 158 158 158 158 158 158 166 167 167 167 167 167 167 177 175 0 0 0 297 0 0 2 2 2 2 2 2 2 
2 2 2 2 0 0 0 0 0 0 91 151 151 151 151 151 151 151 147 146 146 146 146 146 146 145 220 216 215 165 256 146 146 146 146 146 146 146 164 168 168 168 168 168 168 168 174 0 0 0 297 0 0 0 2 2 2 2 2 2 
2 2 2 2 0 0 0 0 0 0 0 0 0 0 0 0 0 0 143 144 144 144 144 144 144 144 139 216 215 162 144 144 144 144 144 144 144 144 271 0 0 0 0 0 0 0 0 0 0 0 297 0 0 0 0 2 2 2 2 2 
2 2 2 2 0 0 0 0 0 0 0 0 0 0 0 0 0 0 142 141 141 141 141 141 141 141 140 216 215 223 163 163 163 163 163 163 163 163 299 219 219 219 219 219 219 219 219 219 219 219 298 0 0 0 0 0 0 0 0 0 
2 2 2 2 0 0 0 0 0 0 0 0 0 0 0 0 0 0 0 0 0 0 0 0 0 0 217 216 215 218 0 0 0 0 0 0 0 0 0 0 0 0 0 0 0 0 0 0 0 0 0 0 0 0 0 0 0 0 0 0 
2 2 2 2 0 0 0 0 0 0 0 0 0 0 0 0 0 0 0 0 0 0 0 0 0 0 217 216 215 218 0 0 0 0 0 0 0 0 0 0 0 0 0 0 0 0 0 0 0 0 0 0 0 0 0 0 0 0 0 0 
2 2 2 2 0 0 0 0 0 0 0 0 0 0 0 0 0 0 0 0 0 0 0 0 0 0 217 216 215 218 0 0 0 0 0 0 0 0 0 0 0 0 0 0 0 0 0 0 0 0 0 0 0 0 0 0 0 0 0 0 
2 2 2 2 0 0 0 0 0 0 0 0 0 0 0 0 0 0 0 0 0 0 0 0 0 0 217 216 215 218 0 0 0 0 0 0 0 0 0 0 0 0 0 0 0 0 0 0 0 0 0 0 0 0 0 2 2 2 2 2 
2 2 2 2 2 0 0 0 0 0 0 0 0 0 0 0 0 0 0 0 0 0 0 0 0 85 217 216 215 218 86 0 0 0 0 0 0 0 0 0 0 0 0 0 0 0 0 0 0 0 0 0 0 0 2 2 2 2 2 2 
2 2 2 2 2 2 2 2 2 2 2 2 2 2 2 2 2 2 2 2 2 2 2 2 2 88 10 10 10 10 87 2 2 2 2 2 2 2 2 2 2 2 2 2 2 2 2 2 2 2 2 2 2 2 2 2 2 2 2 2 
2 2 2 2 2 2 2 2 2 2 2 2 2 2 2 2 2 2 2 2 2 2 2 2 2 88 10 10 10 10 87 2 2 2 2 2 2 2 2 2 2 2 2 2 2 2 2 2 2 2 2 2 2 2 2 2 2 2 2 2 
2 2 2 2 2 2 2 2 2 2 2 2 2 2 2 2 2 2 2 2 2 2 2 2 2 88 10 10 10 10 87 2 2 2 2 2 2 2 2 2 2 2 2 2 2 2 2 2 2 2 2 2 2 2 2 2 2 2 2 2 
