77 77 77 77 84 77 77 77 77 77 77 77 77 77 77 77 77 77 77 77 77 77 77 77 77 77 77 77 77 77 77 77 77 77 77 84 77 77 77 77 83 77 77 77 77 77 77 83 77 77 77 77 77 77 77 77 77 77 77 77 
77 77 77 77 84 77 77 77 77 77 77 77 77 77 77 77 77 77 77 77 77 77 77 77 77 77 77 77 77 77 77 77 77 77 77 84 77 77 77 77 83 77 77 77 77 77 77 83 77 77 77 77 77 77 77 77 77 77 77 77 
77 77 77 77 84 77 77 77 77 77 77 77 77 77 77 77 77 77 77 77 77 77 77 77 77 77 77 77 77 77 77 77 77 77 77 84 77 77 77 77 83 77 77 77 77 77 77 83 77 77 77 77 77 77 77 77 77 77 77 77 
77 77 77 77 84 77 77 77 77 77 77 77 77 77 77 77 77 77 77 77 77 77 77 77 77 77 77 77 77 77 77 77 77 77 77 84 77 77 77 77 83 77 77 77 77 77 77 83 77 77 77 77 77 77 77 77 77 77 77 77 
77 77 77 77 84 77 77 77 77 77 77 77 77 77 77 77 77 77 77 77 77 77 77 77 77 77 77 77 77 77 77 77 77 77 77 84 77 77 77 77 83 77 77 77 77 77 77 83 77 77 77 77 77 77 77 77 77 77 77 77 
77 77 77 77 84 77 77 77 77 77 77 77 77 77 77 77 77 77 77 77 77 77 77 77 77 77 77 77 77 77 77 77 77 77 77 84 77 77 77 77 83 77 77 77 77 77 77 81 77 77 77 77 77 77 77 77 77 77 77 77 
77 77 77 77 84 77 77 77 77 77 77 77 77 77 77 77 77 77 77 77 77 77 305 304 305 305 304 305 304 305 304 305 304 305 304 82 77 77 77 77 83 77 77 77 77 77 77 77 304 305 304 305 305 304 304 305 304 305 304 305 
77 77 77 77 84 304 305 304 305 304 305 77 77 77 77 77 77 77 77 77 77 77 84 77 77 77 77 77 77 77 77 77 77 77 77 77 77 77 77 77 81 304 305 304 305 304 305 304 305 304 305 304 305 304 305 304 305 304 83 77 
77 77 77 77 84 77 77 77 77 77 77 83 77 77 77 77 77 77 77 77 77 77 84 77 77 77 77 77 77 77 77 77 77 77 77 77 77 77 77 77 77 77 77 77 77 77 77 77 77 77 77 77 77 77 77 77 77 77 83 77 
77 77 77 77 84 77 77 77 77 77 77 83 77 77 77 77 77 77 77 77 77 77 84 77 77 77 77 77 77 77 77 77 77 77 77 77 77 77 77 77 77 77 77 77 77 77 77 77 77 77 77 77 77 77 77 77 77 77 83 77 
77 77 77 77 84 77 77 77 77 77 77 83 77 77 77 77 77 77 77 77 77 77 84 77 77 77 77 77 77 77 77 77 77 77 77 77 77 77 77 77 77 77 77 77 77 77 77 77 77 77 306 307 80 80 80 79 78 79 78 79 
77 77 77 77 84 77 77 77 77 77 77 83 77 77 77 77 77 77 77 77 77 77 84 77 77 77 77 77 77 77 77 77 77 77 77 77 77 77 77 77 77 77 77 77 77 77 77 77 77 77 83 77 77 77 77 77 77 77 77 77 
77 77 77 77 84 77 77 77 77 77 77 83 77 77 77 77 77 77 77 77 77 82 82 77 77 77 77 77 77 77 77 77 77 77 77 77 77 77 77 77 77 77 77 77 77 77 77 77 77 77 83 77 77 77 77 77 77 77 77 77 
77 77 77 77 84 77 77 77 77 77 77 83 77 77 77 77 77 77 77 77 82 82 77 77 77 77 77 77 77 77 77 77 77 77 77 77 77 77 77 77 77 77 77 77 77 77 77 77 77 77 83 77 77 77 77 77 77 77 77 77 
77 77 77 77 84 77 77 77 77 77 77 304 305 304 305 304 305 304 305 304 82 77 77 77 77 77 77 77 77 77 77 77 77 77 77 77 77 77 2 77 77 77 77 77 77 77 77 77 77 77 83 77 77 77 77 77 77 77 77 77 
77 77 77 77 84 77 77 77 77 77 77 77 77 77 77 77 77 77 77 77 77 77 77 77 77 77 77 77 77 77 77 77 77 77 77 77 77 77 2 2 77 77 77 77 77 77 77 77 77 77 83 77 77 77 77 77 77 77 77 77 
77 77 77 77 84 77 77 77 77 77 77 77 77 77 77 77 77 77 77 77 77 77 77 77 77 77 77 77 77 77 77 77 77 77 77 77 77 77 2 2 77 77 77 77 77 77 77 77 77 77 83 77 77 77 77 77 77 77 77 77 
77 77 77 77 84 77 77 77 77 77 77 77 77 77 77 77 77 2 2 2 2 77 77 77 77 77 77 77 77 77 77 77 77 77 77 77 77 77 77 77 77 77 77 77 77 77 77 77 77 77 83 77 77 77 77 77 77 77 77 77 
77 77 77 77 84 77 77 77 77 77 77 77 77 77 77 77 77 2 2 2 2 77 77 77 77 77 77 77 77 77 77 77 77 77 77 77 77 77 77 77 77 77 77 77 77 77 77 77 77 77 83 77 77 77 77 77 77 77 77 77 
77 77 77 77 84 77 77 77 77 77 2 2 2 2 2 2 2 2 2 2 2 77 77 77 77 77 77 77 77 77 77 77 77 77 77 77 77 77 77 77 77 77 77 77 77 77 77 77 77 77 83 77 77 77 77 77 77 77 77 77 
77 77 77 77 84 77 77 77 77 77 2 2 2 2 2 2 2 2 2 2 2 77 77 77 77 77 77 77 77 77 77 77 77 77 77 77 77 77 77 77 77 77 77 77 77 77 77 77 77 77 83 77 77 77 77 77 77 77 77 77 
77 77 77 77 84 77 77 77 77 77 2 2 2 2 4 5 2 2 2 2 2 77 77 77 77 77 77 77 77 77 77 77 77 77 77 77 77 77 77 77 77 77 77 77 77 77 77 77 77 77 83 77 77 77 77 77 77 77 77 77 
77 77 77 77 84 77 77 77 77 77 2 2 2 2 6 7 2 2 2 2 2 77 77 77 77 77 77 77 77 77 77 77 77 77 77 77 83 80 80 80 80 80 80 80 80 80 80 80 80 80 80 77 77 77 77 77 77 77 77 77 
77 77 77 77 84 77 77 77 77 77 2 2 2 2 2 2 2 2 2 2 2 77 77 77 77 77 77 77 77 77 77 77 77 77 77 77 83 77 77 77 77 77 77 77 77 77 77 77 77 77 77 77 77 77 77 77 77 77 77 77 
77 77 77 77 84 77 77 77 77 77 2 2 2 2 2 2 2 2 2 2 2 77 77 77 77 77 77 77 77 77 77 77 77 77 77 77 83 77 77 77 77 77 77 77 77 77 77 77 77 77 77 77 77 77 77 77 77 77 77 77 
77 77 77 77 84 77 77 77 77 77 77 77 77 77 77 77 77 77 77 77 77 77 77 77 77 77 77 77 77 77 77 77 77 77 77 77 83 77 77 77 77 77 77 77 77 77 77 77 77 77 77 77 77 77 77 77 77 77 77 77 
77 77 77 77 84 77 77 77 77 77 77 77 77 77 77 77 77 77 77 77 77 77 77 77 77 77 77 77 77 77 77 77 77 77 77 77 83 77 77 77 77 77 77 77 77 77 77 77 77 77 77 77 77 77 77 77 77 77 77 77 
77 77 77 77 84 77 77 77 77 77 77 77 77 77 77 77 77 77 77 77 77 77 77 80 80 80 80 80 80 80 80 80 80 80 80 80 80 77 77 77 77 77 77 77 77 77 77 77 77 77 77 77 77 77 77 77 77 77 77 77 
77 77 77 77 84 77 77 77 77 77 77 77 77 77 77 77 77 77 77 77 77 77 83 77 77 77 77 77 77 77 77 77 77 77 77 77 77 77 77 77 77 77 77 77 77 77 77 77 77 77 77 77 77 77 77 77 77 77 77 77 
77 77 77 77 84 77 77 77 77 77 77 77 77 77 77 77 77 77 77 77 77 77 83 77 77 77 77 77 77 77 77 77 77 77 77 77 77 77 77 77 77 77 77 77 77 77 77 77 77 77 77 77 77 77 77 77 77 77 77 77 
77 77 77 77 84 77 77 77 77 77 77 77 77 77 77 77 77 77 77 77 77 77 83 77 77 77 77 77 77 77 77 77 77 77 77 77 77 77 77 77 77 77 77 77 77 77 77 77 77 77 77 77 77 77 77 77 77 77 77 77 
77 77 77 77 84 77 77 77 77 77 77 77 77 77 77 77 77 77 77 77 77 77 83 77 77 77 77 77 77 77 77 77 77 77 77 77 77 77 77 77 77 77 77 77 77 77 77 77 77 77 77 77 77 77 77 77 77 77 77 77 
77 77 77 77 84 77 77 77 77 77 77 77 77 77 77 77 77 77 77 77 77 77 83 77 77 77 77 77 77 77 77 77 77 77 77 77 77 77 77 77 77 77 77 77 77 77 77 77 77 77 77 77 77 77 77 77 77 77 77 77 
77 77 77 77 84 77 77 77 77 77 77 77 77 77 77 77 77 77 77 77 77 77 83 77 77 77 77 77 77 77 77 77 77 77 77 77 77 77 77 77 77 77 77 77 77 77 77 77 77 77 77 77 77 77 77 77 77 77 77 77 
77 77 77 77 84 77 77 77 77 77 77 77 77 77 77 77 77 77 77 77 77 77 83 77 77 77 77 77 77 77 77 77 77 77 77 77 77 77 77 77 77 77 77 77 77 77 77 77 77 77 77 77 77 77 77 77 77 77 77 77 
77 77 77 77 84 77 77 77 77 77 77 77 77 77 77 77 77 77 77 77 77 77 83 77 77 77 77 77 77 77 77 77 77 77 77 77 77 77 77 77 77 77 77 77 77 77 77 77 77 77 77 77 77 77 77 77 77 77 77 77 
77 77 77 77 84 77 77 77 77 77 77 77 77 77 77 77 77 77 77 77 77 77 83 77 77 77 77 77 77 77 77 77 77 77 77 77 77 77 77 77 77 77 77 77 77 77 77 77 77 77 77 77 77 77 77 77 77 77 77 77 
77 77 77 77 84 77 77 77 77 77 77 77 77 77 77 77 77 77 77 77 77 77 83 77 77 77 77 77 77 77 77 77 77 77 77 77 77 77 77 77 77 77 77 77 77 77 77 77 77 77 77 77 77 77 77 77 77 77 77 77 
77 77 77 77 84 77 77 77 77 77 77 77 77 77 77 77 77 77 77 77 77 77 83 77 77 77 77 77 77 77 77 77 77 77 77 77 77 77 77 77 77 77 77 77 77 77 77 77 77 77 77 77 77 77 77 77 77 77 77 77 
77 77 77 77 84 77 77 77 77 77 77 77 77 77 77 77 77 77 77 77 77 77 83 77 77 77 77 77 77 77 77 77 77 77 77 77 77 77 77 77 77 77 77 77 77 77 77 77 77 77 77 77 77 77 77 77 77 77 77 77 
77 77 77 77 84 77 77 77 77 77 77 77 77 77 77 77 77 77 77 77 77 77 83 77 77 77 77 77 77 77 77 77 77 77 77 77 77 77 77 77 77 77 77 77 77 77 77 77 77 77 77 77 77 77 77 77 77 77 77 77 
77 77 77 77 84 77 77 77 77 77 77 77 77 77 77 77 77 77 77 77 77 77 83 77 77 77 77 77 77 77 77 77 77 77 77 77 77 77 77 77 77 77 77 77 77 77 77 77 77 77 77 77 77 77 77 77 77 77 77 77 
77 77 77 77 84 77 77 77 77 77 77 77 77 77 77 77 77 77 77 77 77 77 83 77 77 77 77 77 77 77 77 77 77 77 77 77 77 77 77 77 77 77 77 77 77 77 77 77 77 77 77 77 77 77 77 77 77 77 77 77 
77 77 77 77 84 77 77 77 77 77 77 77 83 80 80 80 80 80 80 80 80 80 77 77 77 77 77 77 77 77 77 77 77 77 77 77 77 77 77 77 77 77 77 77 77 77 77 77 77 77 77 77 77 77 77 77 77 77 77 77 
77 77 77 77 84 77 77 77 77 77 77 77 83 77 77 77 77 77 77 77 77 77 77 77 77 77 77 77 77 77 77 77 77 77 77 77 77 77 77 77 77 77 77 77 77 77 77 77 77 77 77 77 77 77 77 77 77 77 77 77 
