08 09 08 09 08 09 08 09 08 09 08 09 08 09 08 09 08 09 08 09 08 09 08 09 08 09 08 09 08 09 08 09 08 09 08 09 08 09 08 09 08 09 08 09 08 09 08 09 08 09 08 09 08 09 08 09 08 09 08 09
09 08 09 08 09 08 09 08 09 08 09 08 09 08 09 08 09 08 09 08 09 08 09 08 09 08 09 08 09 08 09 08 09 08 09 08 09 08 09 08 09 08 09 08 09 08 09 08 09 08 09 08 09 08 09 08 09 08 09 08
08 09 08 09 08 09 08 09 08 09 08 09 08 09 08 09 08 09 08 09 08 09 08 09 08 09 08 09 08 09 08 09 08 09 08 09 08 09 08 09 08 09 08 09 08 09 08 09 08 09 08 09 08 09 08 09 08 09 08 09
09 08 09 07 06 07 06 07 06 07 06 07 06 07 06 07 06 07 06 08 09 08 09 07 06 07 06 07 06 07 06 07 06 07 06 07 06 07 06 07 06 07 06 07 06 07 06 07 06 07 06 07 06 07 06 07 06 08 09 08
08 09 07 00 00 00 00 00 00 00 00 00 00 00 00 00 00 00 00 06 08 09 07 00 00 00 00 00 00 00 00 00 00 00 00 00 04 05 00 00 00 00 00 00 00 00 00 00 00 00 00 00 00 00 00 00 00 06 08 09
09 08 05 00 00 00 00 00 00 00 00 00 00 00 00 00 00 00 00 04 09 08 05 00 00 00 00 00 00 00 00 00 00 00 00 00 06 07 00 00 00 00 00 00 00 00 00 00 00 00 00 00 00 00 00 00 00 04 09 08
08 09 07 00 00 00 00 00 00 00 00 00 00 00 00 00 00 00 00 06 08 09 07 00 00 00 00 00 00 00 00 00 00 00 00 00 04 05 00 00 00 00 00 00 00 00 00 00 00 00 00 00 00 00 00 00 00 06 08 09
09 08 05 00 00 00 00 00 00 00 00 00 00 00 00 00 00 00 00 04 09 08 05 00 00 00 00 00 00 00 00 00 00 00 00 00 06 07 00 00 00 00 00 00 00 00 00 00 00 00 00 00 00 00 00 00 00 04 09 08
08 09 07 00 00 00 00 00 00 00 00 00 00 00 00 00 00 00 00 06 08 09 07 00 00 00 00 00 00 00 00 00 00 00 00 00 04 05 00 00 00 00 00 00 00 00 00 00 00 00 00 00 00 00 00 00 00 06 08 09
09 08 05 00 00 00 00 00 00 00 00 00 00 00 00 00 00 00 00 04 09 08 05 00 00 00 00 00 00 00 00 00 00 00 00 00 06 07 00 00 00 00 00 00 00 00 00 00 00 00 00 00 00 00 00 00 00 04 09 08
08 09 07 00 00 00 00 00 00 00 00 00 00 00 00 00 00 00 00 06 08 09 07 00 00 00 00 00 00 00 00 00 04 05 04 05 04 05 00 00 00 00 00 00 00 00 00 00 00 00 00 00 00 00 00 00 00 06 08 09
09 08 05 00 00 04 05 04 05 04 05 04 05 04 05 04 05 04 05 04 09 08 05 04 05 04 05 00 00 00 00 00 06 07 06 07 06 07 00 00 00 00 00 00 00 00 00 00 00 00 00 00 00 00 00 00 00 04 09 08
08 09 07 00 00 06 07 06 07 06 07 06 07 06 07 06 07 06 07 06 07 06 07 06 08 09 07 00 00 00 00 04 05 04 05 04 05 04 05 00 00 00 00 00 00 00 00 00 00 00 00 00 00 00 00 00 00 06 08 09
09 08 05 00 00 00 00 00 00 00 00 00 00 00 00 00 00 00 00 00 00 00 00 00 06 08 05 00 00 00 04 09 08 09 08 09 08 09 08 05 04 05 04 05 04 05 04 05 04 05 04 05 00 00 00 00 00 04 09 08
08 09 07 00 00 00 00 00 00 00 00 00 00 00 00 00 00 00 00 00 00 00 00 00 00 06 07 00 00 00 06 07 06 07 06 07 06 07 06 07 06 07 06 07 06 08 09 08 09 08 09 07 00 00 00 00 00 06 08 09
09 08 05 00 00 00 00 00 00 00 00 00 04 05 04 05 04 05 04 05 00 00 00 00 00 00 00 00 00 00 04 05 00 00 00 00 00 00 00 00 00 00 00 00 04 09 08 09 08 09 08 05 00 00 00 00 00 04 09 08
08 09 08 05 04 05 04 05 00 00 00 00 06 08 09 08 09 08 09 07 00 00 00 00 00 00 00 00 00 00 06 07 00 00 00 00 00 00 00 00 00 00 00 00 06 08 09 08 09 08 09 07 00 00 00 00 00 06 08 09
09 08 09 08 09 08 09 07 00 00 00 00 04 09 08 09 08 09 08 05 04 05 04 05 04 05 04 05 04 05 04 05 04 05 04 05 04 05 04 05 00 00 00 00 04 09 08 09 08 09 08 05 00 00 00 00 00 04 09 08
08 09 08 09 08 09 08 05 00 00 00 00 06 07 06 07 06 07 06 07 06 07 06 07 06 07 06 07 06 07 06 07 06 07 06 08 09 08 09 07 00 00 00 00 06 07 06 07 06 07 06 07 00 00 00 00 00 06 08 09
09 08 09 08 09 08 09 07 00 00 00 00 00 00 00 00 00 00 00 00 00 00 00 00 00 00 00 00 00 00 00 00 00 00 04 09 08 09 08 05 00 00 00 00 00 00 00 00 00 00 00 00 00 00 00 00 00 04 09 08
08 09 08 09 08 09 08 05 00 00 00 00 00 04 05 04 05 04 05 04 05 04 05 04 05 00 00 00 00 00 00 00 00 00 06 08 09 08 09 07 00 00 00 00 00 00 00 00 00 00 00 00 00 00 00 00 00 06 08 09
09 08 09 08 09 08 09 07 00 00 00 00 04 09 08 09 08 09 08 09 08 09 08 09 08 05 00 00 00 00 00 00 00 00 04 09 08 09 08 05 00 00 00 00 04 05 04 05 04 05 04 05 00 00 00 00 00 04 09 08
08 09 08 09 08 09 08 05 00 00 00 00 06 07 06 07 06 07 06 07 06 08 09 08 09 07 00 00 00 00 00 00 00 00 06 08 09 08 09 07 00 00 00 00 06 08 09 08 09 08 09 07 00 00 00 00 00 06 08 09
09 08 09 07 06 07 06 07 00 00 00 00 00 00 00 00 00 00 00 00 04 09 08 09 08 05 00 00 00 00 00 00 00 00 04 09 08 09 08 05 00 00 00 00 04 09 08 09 08 09 08 05 00 00 00 00 00 04 09 08
08 09 07 00 00 00 00 00 00 00 00 00 00 00 00 00 00 00 00 00 06 08 09 08 09 07 00 00 00 00 00 00 00 00 06 08 09 08 09 07 00 00 00 00 06 08 09 08 09 08 09 07 00 00 00 00 00 06 08 09
09 08 05 00 00 00 00 00 00 00 00 00 00 00 00 00 00 00 00 00 04 09 08 09 08 05 00 00 00 00 00 00 00 00 04 09 08 09 08 05 00 00 00 00 04 09 07 06 07 06 07 00 00 00 00 00 00 04 09 08
08 09 07 00 00 00 00 00 00 00 00 00 00 00 00 00 00 00 00 00 06 08 09 08 09 07 00 00 00 00 00 00 00 00 06 08 09 08 09 07 00 00 00 00 06 07 00 00 00 00 00 00 00 00 00 00 00 06 08 09
09 08 05 00 00 00 00 00 00 00 00 00 00 00 00 00 00 00 00 00 04 09 08 09 08 05 00 00 00 00 00 00 00 00 04 09 08 09 08 05 00 00 00 00 04 05 00 00 00 00 00 00 00 00 00 00 00 04 09 08
08 09 07 00 00 00 04 05 04 05 04 05 04 05 04 05 00 00 00 00 06 08 09 08 09 07 00 00 00 00 00 00 00 00 06 08 09 08 09 07 00 00 00 00 06 07 00 00 00 00 00 00 00 00 00 00 00 06 08 09
09 08 05 00 00 00 06 08 09 08 09 08 09 08 09 07 00 00 00 00 04 09 08 09 08 05 04 05 04 05 04 05 04 05 04 09 08 09 08 05 00 00 00 00 04 05 04 05 04 05 04 05 00 00 00 00 00 04 09 08
08 09 07 00 00 00 04 09 08 09 08 09 08 09 08 05 00 00 00 00 06 07 06 07 06 07 06 07 06 07 06 07 06 07 06 07 06 07 06 07 00 00 00 00 06 07 06 07 06 07 06 07 00 00 00 00 00 06 08 09
09 08 05 00 00 00 06 08 09 08 09 08 09 08 09 07 00 00 00 00 00 00 00 00 00 00 00 00 00 00 00 00 00 00 00 00 00 00 00 00 00 00 00 00 00 00 00 00 00 00 04 05 00 00 00 00 00 04 09 08
08 09 07 00 00 00 04 09 08 09 08 09 08 09 08 05 00 00 00 00 00 00 00 00 00 00 00 00 00 00 00 00 00 00 00 00 00 00 00 00 00 00 00 00 00 00 00 00 00 00 06 07 00 00 00 00 00 06 08 09
09 08 05 00 00 00 06 07 06 07 06 07 06 07 06 07 00 00 00 00 00 00 00 00 00 00 00 00 00 00 00 00 00 00 00 00 00 00 00 00 00 00 00 00 00 00 00 00 00 00 04 05 00 00 00 00 00 04 09 08
08 09 07 00 00 00 00 00 00 00 00 00 00 00 04 05 00 00 00 00 04 05 04 05 04 05 00 00 00 00 00 00 04 05 04 05 04 05 04 05 00 00 00 00 04 05 00 00 00 00 06 07 00 00 00 00 00 06 08 09
09 08 05 00 00 00 00 00 00 00 00 00 00 00 06 07 00 00 00 00 06 08 09 08 09 07 00 00 00 00 00 00 06 08 09 08 09 08 09 07 00 00 00 00 06 07 00 00 00 00 00 00 00 00 00 00 00 04 09 08
08 09 07 00 00 00 00 00 00 00 00 00 00 00 04 05 00 00 00 00 04 09 08 09 08 05 00 00 00 00 00 00 04 09 08 09 08 09 08 05 00 00 00 00 04 05 00 00 00 00 00 00 00 00 00 00 00 06 08 09
09 08 05 00 00 00 00 00 00 00 00 00 00 00 06 07 00 00 00 00 06 08 09 08 09 07 00 00 00 00 00 00 06 08 09 08 09 08 09 07 00 00 00 04 09 08 05 04 05 04 05 04 05 04 05 04 05 04 09 08
08 09 07 00 00 00 00 00 00 00 00 00 00 00 04 05 00 00 00 00 04 09 08 09 08 05 00 00 00 00 00 00 04 09 08 09 08 09 08 05 00 00 00 06 07 06 07 06 07 06 07 06 07 06 07 06 08 09 08 09
09 08 05 00 00 00 00 00 00 00 00 00 00 00 06 07 00 00 00 00 06 08 09 08 09 07 00 00 00 00 00 00 06 08 09 08 09 08 09 07 00 00 00 00 00 00 00 00 00 00 00 00 00 00 00 00 06 08 09 08
08 09 07 00 00 00 00 00 00 00 00 00 00 00 04 05 00 00 00 00 04 09 08 09 08 05 00 00 00 00 00 00 04 09 08 09 08 09 08 05 00 00 00 00 00 00 00 00 00 00 00 00 00 00 00 00 04 09 08 09
09 08 05 04 05 04 05 04 05 04 05 04 05 04 09 08 05 04 05 04 09 08 09 08 09 07 00 00 00 00 00 00 06 08 09 08 09 08 09 08 05 04 05 04 05 04 05 04 05 04 05 04 05 04 05 04 09 08 09 08
08 09 08 09 08 09 08 09 08 09 08 09 08 09 08 09 08 09 08 09 08 09 08 09 07 00 00 00 00 00 00 00 04 09 08 09 08 09 08 09 08 09 08 09 08 09 08 09 08 09 08 09 08 09 08 09 08 09 08 09
09 08 09 08 09 08 09 08 09 08 09 08 09 08 09 08 09 08 09 08 09 08 09 08 05 00 00 00 00 00 00 00 06 08 09 08 09 08 09 08 09 08 09 08 09 08 09 08 09 08 09 08 09 08 09 08 09 08 09 08
08 09 08 09 08 09 08 09 08 09 08 09 08 09 08 09 08 09 08 09 08 09 08 09 07 00 00 00 00 00 00 00 04 09 08 09 08 09 08 09 08 09 08 09 08 09 08 09 08 09 08 09 08 09 08 09 08 09 08 09