8 9 8 9 8 9 8 9 8 9 8 9 8 9 8 9 8 9 8 9 8 9 8 9 8 9 8 9 8 9 8 9 8 9 8 9 8 9 8 9 8 9 8 9 8 9 8 9 8 9 8 9 8 9 8 9 8 9 8 9 
9 8 9 8 9 8 9 8 9 8 9 8 9 8 9 8 9 8 9 8 9 8 9 8 9 8 9 8 9 8 9 8 9 8 9 8 9 8 9 8 9 8 9 8 9 8 9 8 9 8 9 8 9 8 9 8 9 8 9 8 
8 9 8 9 8 9 8 9 8 9 8 9 8 9 8 9 8 9 8 9 8 9 8 9 8 9 8 9 8 9 8 9 8 9 8 9 8 9 8 9 8 9 8 9 8 9 8 9 8 9 8 9 8 9 8 9 8 9 8 9 
9 8 9 7 6 7 6 7 6 7 6 7 6 7 6 7 6 7 6 8 9 8 9 7 6 7 6 7 6 7 6 7 6 7 6 7 6 7 6 7 6 7 6 7 6 7 6 7 6 7 6 7 6 7 6 7 6 8 9 8 
8 9 7 0 0 0 0 0 0 0 0 0 0 0 0 0 0 0 0 6 8 9 7 0 0 0 0 0 0 0 0 0 0 0 0 0 4 5 0 0 0 0 0 0 0 0 0 0 0 0 0 0 0 0 0 0 0 6 8 9 
9 8 5 0 0 0 0 0 0 0 0 0 0 0 0 0 0 0 0 4 9 8 5 0 0 0 0 0 0 0 0 0 0 0 0 0 6 7 0 0 0 0 0 0 0 0 0 0 0 0 0 0 0 0 0 0 0 4 9 8 
8 9 7 0 0 0 0 0 0 0 0 0 0 0 0 0 0 0 0 6 8 9 7 0 0 0 0 0 0 0 0 0 0 0 0 0 4 5 0 0 0 0 0 0 0 0 0 0 0 0 0 0 0 0 0 0 0 6 8 9 
9 8 5 0 0 0 0 0 0 0 0 0 0 0 0 0 0 0 0 4 9 8 5 0 0 0 0 0 0 0 0 0 0 0 0 0 6 7 0 0 0 0 0 0 0 0 0 0 0 0 0 0 0 0 0 0 0 4 9 8 
8 9 7 0 0 0 0 0 0 0 0 0 0 0 0 0 0 0 0 6 8 9 7 0 0 0 0 0 0 0 0 0 0 0 0 0 4 5 0 0 0 0 0 0 0 0 0 0 0 0 0 0 0 0 0 0 0 6 8 9 
9 8 5 0 0 0 0 0 0 0 0 0 0 0 0 0 0 0 0 4 9 8 5 0 0 0 0 0 0 0 0 0 0 0 0 0 6 7 0 0 0 0 0 0 0 0 0 0 0 0 0 0 0 0 0 0 0 4 9 8 
8 9 7 0 0 0 0 0 0 0 0 0 0 0 0 0 0 0 0 6 8 9 7 0 0 0 0 0 0 0 0 0 4 5 4 5 4 5 0 0 0 0 0 0 0 0 0 0 0 0 0 0 0 0 0 0 0 6 8 9 
9 8 5 0 0 4 5 4 5 4 5 4 5 4 5 4 5 4 5 4 9 8 5 4 5 4 5 0 0 0 0 0 6 7 6 7 6 7 0 0 0 0 0 0 0 0 0 0 0 0 0 0 0 0 0 0 0 4 9 8 
8 9 7 0 0 6 7 6 7 6 7 6 7 6 7 6 7 6 7 6 7 6 7 6 8 9 7 0 0 0 0 4 5 4 5 4 5 4 5 0 0 0 0 0 0 0 0 0 0 0 0 0 0 0 0 0 0 6 8 9 
9 8 5 0 0 0 0 0 0 0 0 0 0 0 0 0 0 0 0 0 0 0 0 0 6 8 5 0 0 0 4 9 8 9 8 9 8 9 8 5 4 5 4 5 4 5 4 5 4 5 4 5 0 0 0 0 0 4 9 8 
8 9 7 0 0 0 0 0 0 0 0 0 0 0 0 0 0 0 0 0 0 0 0 0 0 6 7 0 0 0 6 7 6 7 6 7 6 7 6 7 6 7 6 7 6 8 9 8 9 8 9 7 0 0 0 0 0 6 8 9 
9 8 5 0 0 0 0 0 0 0 0 0 4 5 4 5 4 5 4 5 0 0 0 0 0 0 0 0 0 0 4 5 0 0 0 0 0 0 0 0 0 0 0 0 4 9 8 9 8 9 8 5 0 0 0 0 0 4 9 8 
8 9 8 5 4 5 4 5 0 0 0 0 6 8 9 8 9 8 9 7 0 0 0 0 0 0 0 0 0 0 6 7 0 0 0 0 0 0 0 0 0 0 0 0 6 8 9 8 9 8 9 7 0 0 0 0 0 6 8 9 
9 8 9 8 9 8 9 7 0 0 0 0 4 9 8 9 8 9 8 5 4 5 4 5 4 5 4 5 4 5 4 5 4 5 4 5 4 5 4 5 0 0 0 0 4 9 8 9 8 9 8 5 0 0 0 0 0 4 9 8 
8 9 8 9 8 9 8 5 0 0 0 0 6 7 6 7 6 7 6 7 6 7 6 7 6 7 6 7 6 7 6 7 6 7 6 8 9 8 9 7 0 0 0 0 6 7 6 7 6 7 6 7 0 0 0 0 0 6 8 9 
9 8 9 8 9 8 9 7 0 0 0 0 0 0 0 0 0 0 0 0 0 0 0 0 0 0 0 0 0 0 0 0 0 0 4 9 8 9 8 5 0 0 0 0 0 0 0 0 0 0 0 0 0 0 0 0 0 4 9 8 
8 9 8 9 8 9 8 5 0 0 0 0 0 4 5 4 5 4 5 4 5 4 5 4 5 0 0 0 0 0 0 0 0 0 6 8 9 8 9 7 0 0 0 0 0 0 0 0 0 0 0 0 0 0 0 0 0 6 8 9 
9 8 9 8 9 8 9 7 0 0 0 0 4 9 8 9 8 9 8 9 8 9 8 9 8 5 0 0 0 0 0 0 0 0 4 9 8 9 8 5 0 0 0 0 4 5 4 5 4 5 4 5 0 0 0 0 0 4 9 8 
8 9 8 9 8 9 8 5 0 0 0 0 6 7 6 7 6 7 6 7 6 8 9 8 9 7 0 0 0 0 0 0 0 0 6 8 9 8 9 7 0 0 0 0 6 8 9 8 9 8 9 7 0 0 0 0 0 6 8 9 
9 8 9 7 6 7 6 7 0 0 0 0 0 0 0 0 0 0 0 0 4 9 8 9 8 5 0 0 0 0 0 0 0 0 4 9 8 9 8 5 0 0 0 0 4 9 8 9 8 9 8 5 0 0 0 0 0 4 9 8 
8 9 7 0 0 0 0 0 0 0 0 0 0 0 0 0 0 0 0 0 6 8 9 8 9 7 0 0 0 0 0 0 0 0 6 8 9 8 9 7 0 0 0 0 6 8 9 8 9 8 9 7 0 0 0 0 0 6 8 9 
9 8 5 0 0 0 0 0 0 0 0 0 0 0 0 0 0 0 0 0 4 9 8 9 8 5 0 0 0 0 0 0 0 0 4 9 8 9 8 5 0 0 0 0 4 9 7 6 7 6 7 0 0 0 0 0 0 4 9 8 
8 9 7 0 0 0 0 0 0 0 0 0 0 0 0 0 0 0 0 0 6 8 9 8 9 7 0 0 0 0 0 0 0 0 6 8 9 8 9 7 0 0 0 0 6 7 0 0 0 0 0 0 0 0 0 0 0 6 8 9 
9 8 5 0 0 0 0 0 0 0 0 0 0 0 0 0 0 0 0 0 4 9 8 9 8 5 0 0 0 0 0 0 0 0 4 9 8 9 8 5 0 0 0 0 4 5 0 0 0 0 0 0 0 0 0 0 0 4 9 8 
8 9 7 0 0 0 4 5 4 5 4 5 4 5 4 5 0 0 0 0 6 8 9 8 9 7 0 0 0 0 0 0 0 0 6 8 9 8 9 7 0 0 0 0 6 7 0 0 0 0 0 0 0 0 0 0 0 6 8 9 
9 8 5 0 0 0 6 8 9 8 9 8 9 8 9 7 0 0 0 0 4 9 8 9 8 5 4 5 4 5 4 5 4 5 4 9 8 9 8 5 0 0 0 0 4 5 4 5 4 5 4 5 0 0 0 0 0 4 9 8 
8 9 7 0 0 0 4 9 8 9 8 9 8 9 8 5 0 0 0 0 6 7 6 7 6 7 6 7 6 7 6 7 6 7 6 7 6 7 6 7 0 0 0 0 6 7 6 7 6 7 6 7 0 0 0 0 0 6 8 9 
9 8 5 0 0 0 6 8 9 8 9 8 9 8 9 7 0 0 0 0 0 0 0 0 0 0 0 0 0 0 0 0 0 0 0 0 0 0 0 0 0 0 0 0 0 0 0 0 0 0 4 5 0 0 0 0 0 4 9 8 
8 9 7 0 0 0 4 9 8 9 8 9 8 9 8 5 0 0 0 0 0 0 0 0 0 0 0 0 0 0 0 0 0 0 0 0 0 0 0 0 0 0 0 0 0 0 0 0 0 0 6 7 0 0 0 0 0 6 8 9 
9 8 5 0 0 0 6 7 6 7 6 7 6 7 6 7 0 0 0 0 0 0 0 0 0 0 0 0 0 0 0 0 0 0 0 0 0 0 0 0 0 0 0 0 0 0 0 0 0 0 4 5 0 0 0 0 0 4 9 8 
8 9 7 0 0 0 0 0 0 0 0 0 0 0 4 5 0 0 0 0 4 5 4 5 4 5 0 0 0 0 0 0 4 5 4 5 4 5 4 5 0 0 0 0 4 5 0 0 0 0 6 7 0 0 0 0 0 6 8 9 
9 8 5 0 0 0 0 0 0 0 0 0 0 0 6 7 0 0 0 0 6 8 9 8 9 7 0 0 0 0 0 0 6 8 9 8 9 8 9 7 0 0 0 0 6 7 0 0 0 0 0 0 0 0 0 0 0 4 9 8 
8 9 7 0 0 0 0 0 0 0 0 0 0 0 4 5 0 0 0 0 4 9 8 9 8 5 0 0 0 0 0 0 4 9 8 9 8 9 8 5 0 0 0 0 4 5 0 0 0 0 0 0 0 0 0 0 0 6 8 9 
9 8 5 0 0 0 0 0 0 0 0 0 0 0 6 7 0 0 0 0 6 8 9 8 9 7 0 0 0 0 0 0 6 8 9 8 9 8 9 7 0 0 0 4 9 8 5 4 5 4 5 4 5 4 5 4 5 4 9 8 
8 9 7 0 0 0 0 0 0 0 0 0 0 0 4 5 0 0 0 0 4 9 8 9 8 5 0 0 0 0 0 0 4 9 8 9 8 9 8 5 0 0 0 6 7 6 7 6 7 6 7 6 7 6 7 6 8 9 8 9 
9 8 5 0 0 0 0 0 0 0 0 0 0 0 6 7 0 0 0 0 6 8 9 8 9 7 0 0 0 0 0 0 6 8 9 8 9 8 9 7 0 0 0 0 0 0 0 0 0 0 0 0 0 0 0 0 6 8 9 8 
8 9 7 0 0 0 0 0 0 0 0 0 0 0 4 5 0 0 0 0 4 9 8 9 8 5 0 0 0 0 0 0 4 9 8 9 8 9 8 5 0 0 0 0 0 0 0 0 0 0 0 0 0 0 0 0 4 9 8 9 
9 8 5 4 5 4 5 4 5 4 5 4 5 4 9 8 5 4 5 4 9 8 9 8 9 7 0 0 0 0 0 0 6 8 9 8 9 8 9 8 5 4 5 4 5 4 5 4 5 4 5 4 5 4 5 4 9 8 9 8 
8 9 8 9 8 9 8 9 8 9 8 9 8 9 8 9 8 9 8 9 8 9 8 9 7 0 0 0 0 0 0 0 4 9 8 9 8 9 8 9 8 9 8 9 8 9 8 9 8 9 8 9 8 9 8 9 8 9 8 9 
9 8 9 8 9 8 9 8 9 8 9 8 9 8 9 8 9 8 9 8 9 8 9 8 5 0 0 0 0 0 0 0 6 8 9 8 9 8 9 8 9 8 9 8 9 8 9 8 9 8 9 8 9 8 9 8 9 8 9 8 
8 9 8 9 8 9 8 9 8 9 8 9 8 9 8 9 8 9 8 9 8 9 8 9 7 0 0 0 0 0 0 0 4 9 8 9 8 9 8 9 8 9 8 9 8 9 8 9 8 9 8 9 8 9 8 9 8 9 8 9 
