77 77 77 77 84 77 77 77 77 77 77 77 77 77 77 77 77 77 77 77 77 77 77 77 77 77 77 77 77 77 77 77 77 77 77 84 77 77 77 77 83 77 77 77 77 77 77 83 77 77 77 77 77 77 77 77 77 77 77 77 
77 77 77 77 84 77 77 77 77 77 77 77 77 77 77 77 77 77 77 77 77 77 77 77 77 77 77 77 77 77 77 77 77 77 77 84 77 77 77 77 83 77 77 77 77 77 77 83 77 77 77 77 77 77 77 77 77 77 77 77 
77 77 77 77 84 77 77 77 77 77 77 77 77 77 77 77 77 77 77 77 77 77 77 77 77 77 77 77 77 77 77 77 77 77 77 84 77 77 77 77 83 77 77 77 77 77 77 83 77 77 77 77 77 84 305 304 305 304 83 77 
77 77 77 77 84 77 77 77 77 77 77 77 77 77 77 77 77 77 77 77 77 77 77 77 77 77 77 77 77 77 77 77 77 77 77 84 77 77 77 77 83 77 77 77 77 77 77 83 77 77 77 77 77 84 77 77 77 77 83 77 
77 77 77 77 84 77 77 77 77 77 77 77 77 77 77 77 77 77 77 77 77 77 77 77 77 77 77 77 77 77 77 77 77 77 77 84 77 77 77 77 83 77 77 77 77 77 77 83 77 77 77 77 77 84 77 77 77 77 83 77 
77 77 77 77 84 77 77 77 77 77 77 77 77 77 77 77 77 77 77 77 77 77 77 77 77 77 77 77 77 77 77 77 77 77 77 84 77 77 77 77 83 77 77 77 77 77 77 81 77 77 77 77 77 84 77 77 77 77 83 77 
77 77 77 77 84 77 77 77 77 77 77 77 77 77 77 77 77 77 77 77 77 77 77 77 77 77 77 305 304 305 304 305 304 305 304 82 77 77 77 77 81 305 304 305 304 305 304 305 304 305 304 305 304 84 77 77 77 77 83 77 
77 77 77 77 84 77 77 77 77 77 77 77 77 77 77 77 77 77 77 77 77 77 77 77 77 77 77 84 77 77 77 77 77 77 77 77 77 77 77 77 77 77 77 77 77 77 77 77 77 77 77 77 77 77 77 77 77 77 83 77 
77 77 77 77 84 77 77 77 77 77 77 77 77 77 77 77 77 77 77 77 77 77 77 77 77 77 77 84 77 77 77 77 77 77 77 77 77 77 77 77 77 77 77 77 77 77 77 77 77 77 77 77 77 77 77 77 77 77 83 77 
77 77 77 77 84 77 77 77 77 77 77 77 77 77 77 77 77 77 77 77 77 77 77 77 77 77 77 84 77 77 77 77 77 77 77 77 77 77 77 77 77 77 77 77 77 77 77 77 77 77 77 77 77 77 77 77 77 77 83 77 
77 77 77 77 84 77 77 77 77 77 77 77 77 77 77 77 77 77 77 77 77 77 77 77 77 77 77 84 77 77 77 77 77 77 77 77 77 77 77 77 77 77 77 77 77 77 77 77 77 77 80 80 80 80 80 79 78 79 78 79 
77 77 77 77 84 77 77 77 77 77 77 77 77 77 77 77 77 77 77 77 77 77 77 77 77 77 77 84 77 77 77 77 77 77 77 77 77 77 77 77 77 77 77 77 77 77 77 77 77 77 83 77 77 77 77 77 77 77 77 77 
77 77 77 77 84 77 77 77 77 77 77 77 77 77 77 77 77 77 77 77 77 77 77 77 77 77 77 84 77 77 77 77 77 77 77 77 77 77 77 77 77 77 77 77 77 77 77 77 77 77 83 77 77 77 77 77 77 77 77 77 
77 77 77 77 84 77 77 77 77 77 77 77 77 77 77 77 77 77 77 77 77 77 77 77 77 77 77 84 77 77 77 77 77 77 83 79 79 79 79 79 79 80 79 78 80 77 77 77 77 77 83 77 77 77 77 77 77 77 77 77 
77 77 77 77 84 77 77 77 77 77 77 77 77 77 77 77 77 77 77 77 77 77 77 77 77 77 77 84 77 77 77 77 77 77 83 77 77 77 77 77 77 77 77 77 84 77 77 77 77 77 83 77 77 77 77 77 77 77 77 77 
77 77 77 77 84 77 77 77 77 77 77 77 77 77 77 77 77 77 77 77 77 77 77 77 77 77 77 84 77 77 77 77 77 77 83 77 77 77 77 77 77 77 77 77 84 77 77 77 77 77 83 77 77 77 77 77 77 77 77 77 
77 77 77 77 84 77 77 77 77 77 77 77 77 77 77 77 77 77 77 77 77 77 77 77 77 77 77 84 77 77 77 77 77 77 83 77 77 77 77 77 77 77 77 77 84 77 77 77 77 77 83 77 77 77 77 77 77 77 77 77 
77 77 77 77 84 77 77 77 77 77 77 77 77 77 77 77 77 77 77 77 77 305 77 77 77 77 77 84 77 77 77 77 77 77 83 77 77 77 77 77 77 77 77 77 84 77 77 77 77 77 83 77 77 77 77 77 77 77 77 77 
77 77 77 77 84 305 305 305 305 305 305 305 305 305 305 305 305 305 305 305 305 305 305 305 305 305 305 305 77 77 77 77 77 77 83 77 77 77 77 77 77 77 77 77 84 77 77 77 77 77 83 77 77 77 77 77 77 77 77 77 
77 77 77 77 84 77 77 77 77 77 77 77 77 77 77 77 77 77 77 77 77 77 77 77 83 77 77 84 77 77 77 77 77 77 83 77 77 77 77 77 77 77 77 77 84 77 77 77 77 77 83 77 77 77 77 77 77 77 77 77 
77 77 77 77 84 77 77 77 77 77 77 77 77 77 77 77 77 77 77 77 77 77 77 77 83 77 77 84 77 77 77 77 77 77 83 77 77 77 77 77 77 77 77 77 84 77 77 77 77 77 83 83 77 77 77 77 77 77 77 77 
77 77 77 77 84 77 77 77 77 77 77 77 77 77 77 77 77 77 77 77 77 77 77 77 83 77 77 84 77 77 77 77 77 77 83 77 77 77 77 77 77 77 77 77 84 77 77 77 77 77 83 77 77 77 77 77 77 77 77 77 
77 77 77 77 84 77 77 77 77 77 77 77 77 77 77 77 77 77 77 77 77 77 77 77 83 77 77 84 77 77 77 77 77 77 305 305 305 305 305 305 305 305 305 305 305 77 77 77 77 77 83 77 77 77 77 77 77 77 77 77 
77 77 77 77 84 77 77 77 77 77 77 77 77 77 77 77 77 77 77 77 77 77 77 77 83 77 77 84 77 77 77 77 77 77 83 77 77 77 77 77 77 77 77 77 77 77 77 77 77 77 83 77 77 77 77 77 77 77 77 77 
77 77 77 77 84 77 77 77 77 77 77 77 77 77 77 77 77 77 77 77 77 77 77 77 83 77 77 84 77 77 77 77 77 77 83 77 77 77 77 77 77 77 77 77 77 77 77 77 77 77 83 77 77 77 77 77 77 77 77 77 
77 77 77 77 84 77 77 77 77 77 77 77 77 77 77 77 77 77 77 77 77 77 77 77 81 305 305 84 77 77 77 77 77 83 80 80 80 80 80 80 80 80 80 80 80 80 80 80 79 80 83 77 77 77 77 77 77 77 77 77 
77 77 77 77 84 77 77 77 77 77 77 77 77 77 77 80 80 80 80 77 77 77 77 77 77 77 77 77 77 77 77 77 77 83 77 77 77 77 77 77 77 77 77 77 77 77 77 77 77 77 77 77 77 77 77 77 77 77 77 77 
77 77 77 77 84 77 77 77 77 77 77 77 77 77 77 83 77 77 84 77 77 77 77 77 77 77 77 77 77 77 77 77 77 83 77 77 77 77 77 77 77 77 77 77 77 77 77 77 77 77 77 77 77 77 77 77 77 77 77 77 
77 77 77 77 84 77 77 77 77 77 77 77 77 77 77 83 77 77 84 77 77 77 77 77 77 77 77 77 77 77 77 77 77 83 77 77 77 77 77 77 77 77 77 77 77 77 77 77 77 77 77 77 77 77 77 77 77 77 77 77 
77 77 77 77 84 77 77 77 77 77 77 77 77 77 77 83 77 77 84 77 77 77 77 77 77 77 77 77 77 77 77 77 77 83 77 77 77 77 77 77 77 77 77 77 77 77 77 77 77 77 77 77 77 77 77 77 77 77 77 77 
77 77 77 77 84 77 77 77 77 77 77 77 77 77 77 83 77 77 84 77 77 77 77 77 77 77 77 77 77 77 77 77 77 83 77 77 77 77 77 77 77 77 77 77 77 77 77 77 77 77 77 77 77 77 77 77 77 77 77 77 
77 77 77 77 84 77 77 77 77 77 77 77 77 77 77 83 77 77 84 77 77 77 77 77 77 77 77 77 77 77 77 77 77 83 77 77 77 77 77 77 77 77 77 77 77 77 77 77 77 77 77 77 77 77 77 77 77 77 77 77 
77 77 77 77 84 77 77 77 77 77 77 77 77 77 77 83 77 77 84 77 77 77 77 77 77 77 77 77 77 77 77 77 77 83 77 77 77 77 77 77 77 77 77 77 77 77 77 77 77 77 77 77 77 77 77 77 77 77 77 77 
77 77 77 77 84 77 77 77 77 77 77 77 77 77 77 83 77 77 84 77 77 77 77 77 77 77 77 77 77 77 77 77 77 83 77 77 77 77 77 77 77 77 77 77 77 77 77 77 77 77 77 77 77 77 77 77 77 77 77 77 
77 77 77 77 84 77 77 77 77 77 77 77 77 77 77 83 77 77 84 77 77 77 77 77 77 77 77 77 77 77 77 77 77 83 77 77 77 77 77 77 77 77 77 77 77 77 77 77 77 77 77 77 77 77 77 77 77 77 77 77 
77 77 77 77 84 77 77 77 77 77 77 77 77 77 77 83 77 77 84 77 77 77 77 83 80 80 80 80 80 80 80 80 80 80 77 77 77 77 77 77 77 77 77 77 77 77 77 77 77 77 77 77 77 77 77 77 77 77 77 77 
77 77 77 77 84 308 77 77 77 77 77 77 77 77 77 83 77 77 84 77 77 77 77 83 77 77 77 77 77 77 77 77 77 77 77 77 77 77 77 77 77 77 77 77 77 77 77 77 77 77 77 77 77 77 77 77 77 77 77 77 
77 77 77 77 84 311 310 77 77 77 77 77 77 77 77 83 77 77 84 77 77 77 77 83 77 77 77 77 77 77 77 77 77 77 77 77 77 77 77 77 77 77 77 77 77 77 77 77 77 77 77 77 77 77 77 77 77 77 77 77 
77 77 77 77 84 77 77 77 77 77 77 77 77 77 77 83 77 77 84 77 77 77 77 83 77 77 77 77 77 77 77 77 77 77 77 77 77 77 77 77 77 77 77 77 77 77 77 77 77 77 77 77 77 77 77 77 77 77 77 77 
77 84 313 77 84 311 77 77 77 77 77 77 77 77 77 83 77 77 84 77 77 77 77 83 77 77 77 77 77 77 77 77 77 77 77 77 77 77 77 77 77 77 77 77 77 77 77 77 77 77 77 77 77 77 77 77 77 77 77 77 
77 84 312 81 82 309 77 77 77 77 77 77 77 308 308 83 77 77 84 77 77 77 77 83 77 77 77 77 77 77 77 77 77 77 77 77 77 77 77 77 77 77 77 77 77 77 77 77 77 77 77 77 77 77 77 77 77 77 77 77 
77 84 77 77 77 77 77 77 77 77 77 77 77 308 308 83 77 77 84 77 77 77 77 83 77 77 77 77 77 77 77 77 77 77 77 77 77 77 77 77 77 77 77 77 77 77 77 77 77 77 77 77 77 77 77 77 77 77 77 77 
77 84 77 77 77 77 77 77 77 77 77 77 308 308 308 83 77 77 84 77 77 77 77 83 77 77 77 77 77 77 77 77 77 77 77 77 77 77 77 77 77 77 77 77 77 77 77 77 77 77 77 77 77 77 77 77 77 77 77 77 
77 84 80 80 80 80 80 80 80 80 80 80 80 80 80 80 80 80 80 80 80 80 80 80 77 77 77 77 77 77 77 77 77 77 77 77 77 77 77 77 77 77 77 77 77 77 77 77 77 77 77 77 77 77 77 77 77 77 77 77 
77 77 77 77 77 77 77 77 77 77 77 77 77 77 77 77 77 77 77 77 77 77 77 77 77 77 77 77 77 77 77 77 77 77 77 77 77 77 77 77 77 77 77 77 77 77 77 77 77 77 77 77 77 77 77 77 77 77 77 77 
